16 16 0
### ######## ###
### ######## ###
##   o ## o   ##
## # #    # # ##
## # ###### # ##
## # D R  D # ##
## # #ICPB# # ##
## # ###### # ##
  ..............
## ### ## ### ##
## #   @    # ##
## # ###### # ##
## # ###### # ##
##   o    o   ##
### ######## ###
### ######## ###