16 16 0
### ######## ###
##  ######## ###
## ## D ###   ##
## #  #   # # ##
## # #### # # ##
## # # R  # # ##
##   #ICPB# # ##
########### # ##
  ..............
## ### ....## ##
## #   @..  # ##
## # ###### # ##
## # ###### # ##
##   o    o   ##
### ######## ###
### ######## ###