16 16 0
############ ###
############ ###
##    .       ##
##    .       ##
##    .       ##
##    .       ##
##            ##
##     @      ##
##            ##
##         B  ##
##DDDDDDDDDDDD##
##    ICP     ##
##  R         ##
##            ##
############ ###
############ ###